Gra typu strategii modyfikacyjnej z widokiem typu Warcraft 3 (Widok z pewnego skosu, bardziej od góry). Gra jest w pełni modyfikowalna, w tym pozwala tworzyć własne mapy, mechaniki dla elementów i własnych zasad gry. Przechodząc z góry przygotowane scenariusze odblokowujemy nowe postacie, które następnie możemy wykorzystywać w trybie swobodnej gry.

Tryb Ultimate Żołnierzyki:
- Jednostka z karabinem -> Standardowa jednostka
- Jednostka z małym pistoletem -> Szybsza od jednostki z karabinem, ale i dużo wolniej strzelająca
- Jednostka z muszkietem -> Jednostka ruszająca się wolniej od standardowej jednostki, strzela też dużo wolniej, zadaje natomiast dużo większe obrażenia i jego strzały przebijają pancerz
- Jednostka z karabinem maszynowym -> Powolna jednostka o ogromnej szybkostrzelności. Może jej się skończyć amunicja, dodatkowo musi się rozłożyć przed rozpoczęciem ostrzału, co zabiera czas i mocno ogranicza jego możliwości ofensywne
- Jednostka z UZI – Szybka jednostka z bronią o bardzo dużej szybkostrzelności. Może jej się skończyć amunicja i zawiera jej bardzo mało
- Jednostka z Bazooką – Powolna jednostka o bardzo małej szybkostrzelności. Strzał zadaje obrażenia obszarowe i przebija pancerz. Ma mocno ograniczoną amunicję.
- Jednostka z granatami – Szybka jednostka o małej precyzji ataku. Granat zadaje obrażenia obszarowe i pozwala przebić pancerz. Granaty są ograniczone
- Jednostka z lunetą – Jednostka o dużej szybkości odsłaniająca większą połać terenu. Bezbronna
- Kapitan – Postać o większej żywotności od normalnej jednostki. Mogąca nosić ze sobą 2 wymienne bronie.
- Bronie – Na mapie można znaleźć leżące bronie. Jednostka może wymienić swoją broń na inną jednocześnie zmieniając swój typ.
- Odmiany jednostek – Każda jednostka ma kilka wariacji. Przykładowo jednostka z karabinem może posiadać różne rodzaje karabinów. Jego statystyki wówczas będą lekko się różnić, a także otrzyma on inną umiejętność specjalną.
- Paczki z amunicją – kolejny element, który możemy znaleźć na mapie. Pozwala on zregenerować amunicję postaci. Uwaga wyróżniamy różne typy paczek z amunicją. Różniące się pojemnością i rodzajem regenerującej amunicji.
- Apteczki – element leczący jednostki, które go znalazły. Wyczerpuje się po kilku postaciach

Jednostki do odblokowania:
- Jednostka z miotaczem płomieni – Powolna jednostka o ograniczonym zasięgu ataku. Zawiera atak obszarowy
- Drwal (Jednostka z piłą łańcuchową) – szybka jednostka o bardzo małym zasięgu ataku. Tworzy spustoszenie przy bliskim kontakcie z armią oponenta
- Siłacz – Jednostka pozwalająca podnosić paczki z amunicją, apteczki i bronie w inne miejsce. Bardzo szybka bez ładunku, powolna z ładunkiem. Atakuje z pięści co bardzo ogranicza jej zasięg i szybkość ataku
- Strażak (Jednostka z siekierą) – powolna jednostka o powolnym ataku na krótką odległość. Odporna na ogień i pozwalająca na rozwalanie niektórych barier
- Grajek (Jednostka z dudami/instrumentem) – szybka jednostka wzmacniająca/przyśpieszająca jednostki sojusznicze na danym obszarze

Dodatek Indiański:
- Szaman – Powolna jednostka o zerowym ataku. Pozwala co jakiś czas wskrzesić zmarłą jednostkę
- Łucznik – Szybka jednostka o małej szybkostrzelności. Jej atak nie wydaje dźwięku. Może jeździć na koniu
- Koń – Jednostka, na której wyszczególnione postacie mogą jeździć. Bardzo szybka
- kowboj – Jednostka z dwoma pistoletami o dużej szybkostrzelności, ale z ograniczoną amunicją. Może jeździć na koniu 
- Wódz – Kapitan, który nie może zginąć. Jego śmierć = przegranej.

Dodatek Średniowieczny:
- Rycerz (Jednostka z mieczem) – Jednostka z małym zasięgiem atakująca jedną postać na raz. Posiada pancerz. Może jeździć na koniu, ale nie może z niego atakować.
- Halabardnik – Jednostka opancerzona o średnim zasięgu ataku, atakująca wszystkich w zasięgu ataku.
- Jeździec – Jednostka opancerzona, która może atakować tylko będąc na koniu. Na koniu osiąga ogromne prędkości i przebija pancerz
- Medyk – Karta mogąca leczyć inne karty
